msgFunctionNotAvailable = The function %s is not available.
msgSaveChanges = Save changes to the document ”%s“?
msgRevert = Revert to the latest version of ”%s“?
msgDontSave = Don't Save
msgSave = Save
msgCancel = Cancel
msgSaveTitle = Save ”%s“
msgFileFormat = Format
msgDefault = Default
msgLinkHere = Create Link Here
msgMoveHere = Move Here
msgCopyHere = Copy Here
msgCut = Cut
msgCopy = Copy
msgPaste = Paste
msgPasteSpecial = Paste Special…
msgClear = Clear
msgSelectAll = Select All
msgInsertFunction = Insert Function…
msgIncorrectFormula = This file contains an incorrect formula in cell %s.
msgNoMoreWarnings = Shut Up
msgOK = OK
msgOpenTextFile = If ’%s‘ is a text file, is it tab or comma delimited?
msgTab = Tab
msgComma = Comma
msgNoNames = <No names defined>
msgNoGraphsFound = No graph plugins found!
msgIncorrectValue = This is not a valid value.
msgMustBeIntegral = The difference between first and last date must be an integral value.
msgShowGrid = Show Grid
msgHideGrid = Hide Grid
msgShowHead = Show Headings
msgHideHead = Hide Headings
msgHasFormula = Can't automatically change this cell since it contains a formula.
msgChooseColor = Color Picker
msgSaveAsSYLK = SYLK
msgSaveAsCSV = Comma Separated Values
msgSaveAsTabDelimited = Tab Delimited
